appetite = iştah/afiyet
activites that give you natural high = mutluluk verici faaliyetler
leisure/leisurely = rahat/rahatça/acele etmeden
strain = baskı,basınç
waistline = gövdedeki yağ oranı 
citrus fruits = sulu meyveler (portakal,limon vs.)
versatile = birden fazla şey yapabilmek
commodity = yararlı bir şey
sturdy = dayanıklı
herb = koku veya tat verici bitki (mint,nane gibi)
perennial = uzun süre devam eden,yaşayan
cultivate something = yetiştirmek
ample = yeterli
propagate = bir şeyi yaymak
offshoot = büyük bir şirketin küçük kolları. (her zaman şirket olmak zorunda değil)
specimen = önizleme,örnek
sustain = yeterli olmak,bir süreliğine devam edebilmeyi sağlamak
regulate = kontolü sağlamak,normale döndürmek
debiliate = zayıflatmak
crave = arzulamak
cartilage = kıkırdak
soothe = rahatlatmak
ripe = olgunlaşmak
stream = küçük nehir
immerse = get involved in something.
umpire = tennis referee (tenis hakemi)
pitch = saha 
circuit = pist 
track = koşu pisti
charm = süs eşyası
grumble = guruldamak/hafif ses çıkartmak
tweezers = cımbız
bun = küçük hamburger ekmeği
deception/decieve = kandırmak
figure = bulgular(yazınsal)
proportion = oran
nursery = çocuk bakım evi
decade = on yıllık dönem
crisp = cips
crossed/crossly = kızgın/kızgınca
moor = ağaçsız,otsuz,etrafında hiçbir şey olmayan arazi,çöl
servant = hizmetçi
robin = bir tür kuş
horrid = hoş olmayan/horrible
crooked = kambur
abstract = soyut
concrete = somut
fancying something/someone = birisinden veya bir şeyden hoşlanmak(liking)
inflatable = şişirilebilir
digitized = sanallaştırılmış/gerçek değil
irrigation = sulama(tarım)
witty = kurnaz
anticipate = beklemek
objection = itiraz
eruption = patlama
persevere = azim
compulsory = zorunlu
tibia = kaval kemiği
urge = niyet
urgent = önemli
suburb = şehir merkezi dışındaki yerleşim yerleri
attic = çatı katı
chimney = baca
terrace = bahçe zemini
cottage = küçük kırsal alan evi (köy evi gibi)
spacious = geniş (space)
outskirts = şehirden çok daha uzak yerleşim yeri(suburb ile karşılaştırınca)
ground floor = zemin kat
first floor = birinci kat(zeminin bir üstü)
cosy = rahat,sıcak,güzel
residential area = yerleşim yeri
resign = imza veya istifa etmek
redundant = gereksiz
sack = işten atmak